SANS_OBJECTIF;;;;;;;;;
NB_LIG;10;;;;;;;;
NB_COL;10;;;;;;;;
B;B;B;B;B;B;B;B;B;B
V;V;T;R;R;R;R;V;R;R
T;T;T;T;T;D;T;D;T;T
B;B;B;B;B;B;B;B;B;V
B;T;T;T;T;T;T;T;T;M
B;T;T;B;B;B;B;B;B;B
B;T;T;T;T;T;T;T;T;D
B;T;T;T;T;D;T;T;T;T
B;T;T;T;D;T;T;T;T;V
B;T;T;T;T;T;T;T;T;M
