SANS_OBJECTIF;;;;;;;;;
NB_LIG;10;;;;;;;;
NB_COL;10;;;;;;;;
V;V;V;V;B;V;V;V;V;V
V;V;V;V;B;B;B;B;B;M
V;V;V;R;R;R;R;V;B;V
V;V;V;T;T;T;T;D;B;M
V;V;V;V;V;V;V;V;B;V
V;D;V;V;V;V;V;V;B;M
V;V;V;V;V;V;V;V;B;V
V;V;V;M;M;M;M;V;B;M
B;B;B;B;B;B;B;B;B;V
V;M;M;V;M;V;V;V;M;V
