SANS_OBJECTIF;;;;;;;;;
NB_LIG;10;;;;;;;;
NB_COL;10;;;;;;;;
T;T;T;V;V;R;T;R;B;T
T;V;T;R;V;B;T;T;B;T
T;T;T;B;V;V;R;V;B;V
T;T;T;T;M;V;B;V;B;V
T;T;T;T;B;V;V;V;B;T
T;T;T;T;T;M;V;R;B;T
T;T;T;T;T;B;V;T;B;V
T;T;T;T;T;T;M;V;B;V
T;T;T;T;T;T;B;V;B;V
T;T;T;T;T;T;T;M;D;V
