SANS_OBJECTIF;;;;;;;;;
NB_LIG;10;;;;;;;;
NB_COL;10;;;;;;;;
V;V;V;V;V;V;R;V;D;V
V;V;R;V;V;V;T;V;T;V
B;B;B;V;V;V;V;V;V;V
V;V;V;V;V;V;R;V;D;V
V;V;V;V;V;T;T;T;T;T
V;V;D;M;V;T;D;T;D;T
R;V;B;B;B;T;T;T;T;T
T;T;V;V;R;R;R;V;V;V
D;T;V;V;R;R;R;V;T;T
T;T;V;V;R;R;V;V;T;D
